48 0 0 0 0 0 0 0 0 0 0 32 32 
17 17 17 17 17 17 17 17 0 0 17 0 0 
0 0 0 96 0 0 0 0 0 0 17 0 0 
0 0 32 17 0 0 0 0 17 0 17 0 0 
96 17 0 0 0 0 0 0 17 0 17 0 0 
0 17 0 0 17 17 17 0 17 96 17 0 0 
0 17 0 0 17 48 17 0 17 0 17 0 0 
0 0 0 0 17 96 17 0 17 0 17 0 0 
0 0 0 0 0 0 0 0 17 0 17 0 0 
32 32 17 17 17 17 17 18 18 0 0 0 0 
18 18 64 32 0 0 0 0 0 17 0 0 0 
32 0 32 0 0 96 0 0 0 0 0 0 0 
 0 0 
 0 0 0 
 
7 32 32 32 32 32 32 32 0 0 17 17 
17 17 32 32 32 32 32 32 32 0 0 48 48 
