48 25 64 25 32 25 0 0 0 25 0 24 24 
0 25 0 0 0 0 0 25 0 19 0 24 24 
0 32 0 0 96 25 0 0 0 25 0 24 24 
25 0 25 25 0 0 0 25 0 19 0 24 24 
0 0 0 0 0 25 0 0 96 25 0 48 48 
0 0 0 25 0 0 0 25 0 19 0 24 24 
0 25 0 0 0 25 0 0 0 25 0 24 24 
0 0 0 25 0 0 0 25 0 19 0 0 0 
25 96 0 25 0 25 21 25 0 25 0 25 25 
0 0 0 0 96 0 0 0 0 19 0 0 0 
0 25 0 25 0 25 0 25 0 25 0 25 25 
0 0 0 0 0 0 0 0 0 19 0 0 0 
6 0 0 0 
 
7 32 32 32 32 32 32 32 0 0 17 17 
17 17 32 32 32 32 32 32 32 0 0 48 48 
