18 18 18 18 18 18 18 18 18 18 18 18 18 
48 0 0 0 0 0 96 0 0 22 18 18 18 
18 0 0 0 0 0 96 0 0 0 0 18 18 
18 0 0 0 0 0 18 0 0 0 0 18 18 
18 18 0 0 0 18 18 18 0 0 0 18 18 
18 18 18 96 18 18 18 18 18 19 18 18 18 
18 18 0 0 0 18 18 18 0 0 0 18 18 
18 0 32 0 32 0 18 48 0 0 0 18 18 
18 0 32 0 32 0 18 0 0 22 0 18 18 
18 21 32 0 32 64 18 0 0 0 32 18 18 
18 18 0 0 0 18 18 18 0 0 18 18 18 
18 18 18 18 18 18 18 18 18 18 18 18 18 
0 0 17 17 
17 17 32 32 32 32 32 32 32 0 0 48 48 
