48 0 32 32 32 32 32 32 32 32 32 17 17 
0 0 32 32 32 32 32 32 32 32 32 17 17 
17 17 32 32 32 32 32 32 32 32 32 17 17 
17 17 32 32 32 32 32 32 32 32 32 17 17 
17 17 32 32 32 32 32 32 32 32 32 17 17 
17 17 32 32 32 32 32 32 32 32 32 17 17 
17 17 32 32 32 32 32 32 32 32 32 17 17 
17 17 32 32 32 32 32 32 32 32 32 17 17 
17 17 32 32 32 32 32 32 32 32 32 17 17 
17 17 32 32 32 32 32 32 32 64 32 17 17 
17 17 32 32 32 32 32 32 32 0 0 17 17 
17 17 32 32 32 32 32 32 32 0 0 48 48 
