48 0 0 0 0 96 0 80 0 0 0 0 0 
17 17 17 0 17 0 17 17 17 17 0 0 0 
0 0 0 0 17 32 17 0 0 17 0 0 0 
32 0 0 0 17 32 17 0 0 17 0 0 0 
0 0 0 0 17 32 17 0 0 17 0 0 0 
0 0 0 21 17 17 17 0 0 17 0 0 0 
0 0 0 0 0 0 0 0 0 17 0 0 0 
0 18 32 18 0 96 0 0 0 17 0 0 0 
0 18 18 18 96 0 0 0 0 17 0 0 0 
19 0 0 0 0 0 0 0 0 17 0 0 0 
0 17 17 17 17 17 17 17 17 17 38 0 0 
0 0 48 0 0 0 0 0 0 0 0 64 64 

0 17 0 96 0 0 0 
 
7 32 32 32 32 32 32 32 0 0 17 17 
17 17 32 32 32 32 32 32 32 0 0 48 48 
