48 0 0 0 0 0 0 0 0 0 0 0 0 
17 17 17 17 17 17 17 17 17 17 17 0 0 
0 0 0 0 0 96 0 0 21 0 0 0 0 
0 17 17 17 17 17 17 17 17 17 17 23 23 
0 0 96 0 0 0 0 0 0 64 0 0 0 
23 17 17 17 17 17 17 17 17 17 17 0 0 
0 0 0 96 0 0 0 0 0 0 0 0 0 
0 17 17 17 17 17 17 17 17 17 17 23 23 
0 17 17 17 96 0 0 0 32 17 0 0 0 
19 0 0 0 0 0 0 32 0 17 0 0 0 
0 17 17 17 17 17 17 17 17 17 38 0 0 
0 0 48 0 0 0 0 0 0 0 0 0 0 

 
7 32 32 32 32 32 32 32 0 0 17 17 
17 17 32 32 32 32 32 32 32 0 0 48 48 
