0 0 0 0 17 0 17 96 0 0 17 64 64 
17 17 17 0 17 0 17 0 17 0 17 0 0 
32 0 17 0 17 0 17 0 17 0 17 0 0 
96 0 0 0 0 0 0 0 17 96 0 0 0 
0 17 17 17 0 32 17 17 17 17 17 17 17 
0 0 0 21 0 17 0 96 0 0 0 96 96 
0 17 17 17 0 17 0 0 0 17 17 96 96 
0 96 0 0 0 17 0 0 0 17 17 96 96 
17 17 17 17 19 17 96 17 0 17 0 0 0 
0 0 0 0 0 0 0 17 0 17 17 0 0 
0 17 17 17 0 17 17 17 96 17 0 0 0 
32 17 32 0 0 96 0 17 0 17 0 20 20 
32 32 32 32 32 32 0 0 17 17 
17 17 32 32 32 32 32 32 32 0 0 48 48 
